+-+-+-+-+-+
|   | | | |
+-+ + + + +
|     |   |
+ +-+ +-+ +
|     |   |
+-+-+ +-+ +
|       | |
+ +-+-+ + +
|         |
+-+-+-+-+-+
